A	AH
A(2)	EY
ALARM	AH L AA R M
BE	B IY
BOOK	B UH K
COFFEE	K AA F IY
COFFEE(2)	K AO F IY
EXERCISE	EH K S ER S AY Z
FLIGHT	F L AY T
FOOD	F UW D
GET	G EH T
GET(2)	G IH T
GRATEFUL	G R EY T F AH L
HEY	HH EY
I	AY
JIM	JH IH M
LOVE	L AH V
MEDITATE	M EH D AH T EY T
MUSIC	M Y UW Z IH K
NEWS	N UW Z
NEWS(2)	N Y UW Z
PLAY	P L EY
SEARCH	S ER CH
SET	S EH T
SOCIAL	S OW SH AH L
SPORTS	S P AO R T S
STOP	S T AA P
THE	DH AH
THE(2)	DH IY
WEATHER	W EH DH ER
YOU	Y UW
